Hd, Hd, Hd, Hd, Hd, Hd, Hd, Gd^Fts, Gd, Dd, Dd, Gd, Rd, Rd, Gs, Gs^Es, Dd^Esd, Dd, Dd, Hhd^Fts, Dd, Dd, Gd^Efm, Gd, Gs, Wwf, Ww, Wwr, Ww, Wwf, Wwf, Wwf
Hd, Hd, Hd, Hd^Ftd, Hd, Hd, Hd, Dd, Dd^Esd, Gd^Fts, Gd^Fts, Gd^Fts, Rd, Gd, Gd^Efm, Gs, Dd, Dd, Dd, Hhd^Fts, Hhd^Fts, Hhd^Fts, Dd^Esd, Dd, Gs, Wwf, Wwf, Ww, Wwf, Wwf, Wwf, Wwf
Hd, Hd, Hd, Hd^Ftd, Hd^Ftd, Hd, Hd, Dd^Esd, Dd, Hd, Dd, Rd, Dd^Esd, Gd^Fts, Gd^Fts, Gd, Gd^Es, Gd^Es, Hhd^Fts, Hhd^Fts, Hhd^Fts, Hhd, Hhd, Gd^Fts, Rd, Gs, Gs^Ftp, Wwf, Wwf, Wwf, Wwf, Wwf
Hd^Ftd, Hd^Ftd, Hd^Ftd, Cd, Cd, Cd, Rd, Dd, Hd, Hd, Rd, Rd, Hd, Dd^Esd, Dd^Edb, Dd, Gd^Fts, Gd^Fts, Hhd, Hhd, Hhd^Fts, Hhd, Rd, Rd, Gd^Fts, Cd, Cd, Cd, Dd, Dd, Dd^Edp, Wwf
Hd^Ftd, Hd^Ftd, Hd^Ftd, Cd, 2 Kd, Cd, Dd^Ftd, Rd, Rd, Rd, Hd, Hd, Hd, Dd, Dd^Edp, Dd, Dd, Dd^Esd, Hd, Hhd, Hhd^Fts, Rd, Hd, Dd, Dd, Cd, 1 Kd, Cd, Rd, Dd, Dd, Gd
Mdd, Hd^Ftd, Rd, Rd, Rd, Hd^Ftd, Dd^Ftd, Dd^Ftd, Dd^Esd, Dd^Esd, Hd^Vdt, Hhd, Hhd, Gd^Fts, Dd^Dc, Dd^Edb, Dd^Vda, Dd, Rd, Hhd, Rd, Rd, Hd, Dd, Dd, Rd, Dd, Dd^Edb, Rd, Dd^Ftd, Dd, Dd
Rd, Rd, Ww, Ww, Rd, Dd, Dd^Vda, Dd, Dd^Esd, Dd, Gd, Dd^Esd, Gd, Hhd, Rd, Dd, Rd, Rd, Dd, Rd, Gd^Fts, Hhd, Hd, Dd^Vda, Rd, Rd, Dd, Gd^Fts, Dd, Rd, Rd, Gd
Ww, Ww, Ww, Ww, Cd, Wwr, Dd, Dd^Ftd, Dd, Hhd, Gd^Fts, Dd, Rd, Rd, Dd, Rd, Dd, Dd, Dd, Dd^Esd, Dd, Dd, Hd, Dd, Rd, Dd^Esd, Dd, Gd^Fts, Gd^Fts, Gd^Fts, Gd^Vht, Rd
Ww, Ww, Cd, Ww, Ww, Rd, Dd^Ftd, Dd, Dd^Edpp, Hhd, Rd, Rd, Gd, Gd^Fts, Dd, Dd, Dd^Ftd, Dd, Dd^Edpp, Dd^Esd, Dd, Dd, Rd, Rd, Dd, Dd, Dd, Dd, Gd^Fts, Dd, Dd^Esd, Rd
Ww, Cd, Ww, Rd, Cd, Rd, Rd, Dd^Edpp, Dd, Rd, Gd^Es, Hhd^Fts, Dd, Hhd, Gd^Fts, Dd, Dd^Ftd, Dd, Dd, Dd, Rd, Rd, Dd, Dd^Ftd, Dd^Dr, Dd, Dd, Dd, Dd, Dd, Dd^Ftd, Rd
Mdd, Wwr, Ww, Hd, Rd, Rd, Dd^Esd, Rd, Rd, Rd, Hhd, Hhd, Hhd^Fts, Hhd, Hhd, Gd^Fts, Dd^Esd, Dd^Ftd, Dd^Ftd, Dd^Edpp, Rd, Gd^Fts, Dd, Dd, Dd, Dd^Edp, Dd^Ftd, Dd^Ftd, Dd^Ftd, Dd^Esd, Dd^Ftd, Rd
Hd, Hd^Ftd, Hd^Ftd, Hhd, Rd, Dd^Ftd, Dd, Dd^Esd, Dd, Dd^Esd, Hhd, Hhd, Hhd, Hhd, Gd, Gd^Fts, Rd, Rd, Rd, Rd, Dd, Gd^Fts, Gd^Fts, Dd, Dd, Dd, Dd, Dd, Dd, Hd^Ftd, Hd^Ftd, Dd
Dd, Dd, Rd, Rd, Dd^Vda, Dd, Dd^Ftd, Dd^Esd, Dd, Dd^Edp, Gd^Fts, Gd, Hhd, Hhd, Rd, Rd, Gd^Fts, Gd^Fts, Dd, Gd^Fts, Gd^Fts, Gd^Es, Gd^Fts, Dd, Dd, Dd^Esd, Dd^Edp, Dd, Hhd, Hd^Vda, Dd^Ftd, Dd
Dd^Esd, Dd, Rd, Dd^Edpp, Dd, Dd, Dd, Dd, Dd^Esd, Dd, Gd^Fts, Gd, Gd^Fts, Rd, Dd^Esd, Hd, Gd^Fts, Gd, Gd, Gd^Fts, Gd, Gd, Gd, Gd^Vht, Dd, Dd, Dd^Edpp, Hd^Ftd, Hd^Ftd, Hd^Ftd, Dd^Edp, Dd^Ftd
Dd^Ftd, Dd, Dd^Dc, Rd, Dd, Dd, Dd^Esd, Dd, Dd, Dd, Gd^Fts, Dd, Rd, Cd, Cd, Cd, Dd, Gd^Fts, Dd^Vdr, Gd, Gd^Fts, Gd^Fts, Gd, Gd^Fts, Dd, Dd^Ftd, Dd^Ftd, Dd^Esd, Hd^Ftd, Hd^Ftd, Dd, Hd
Dd, Dd^Esd, Gd, Rd, Dd^Esd, Dd, Dd, Dd, Dd^Edpp, Gd^Fts, Gd, Gd, Rd, Cd, 5 Kd, Cd, Dd^Esd, Gd^Fts, Dd^Edpp, Gd^Fts, Gd^Es, Gd^Fts, Gd^Fts, Dd^Edp, Dd^Ftd, Dd^Ftd, Dd, Dd, Dd^Esd, Hd^Ftd, Dd, Dd^Esd
Dd, Gd^Fts, Gd, Rd, Gd^Fts, Gd^Fts, Gd, Gd, Gd, Gd^Fts, Gd, Dd, Rd, Dd^Vda, Rd, Dd, Dd, Dd, Gd, Dd, Dd^Esd, Gd^Es, Dd^Dc, Dd^Esd, Dd, Dd, Dd, Dd, Dd, Hd^Ftd, Hd^Ftd, Hd
Dd^Dr, Gd^Fts, Gd, Rd, Gd^Es, Gd, Gd, Dd^Esd, Dd, Gd^Fts, Rd, Rd, Gs^Ftp, Dd, Rd, Dd^Edpp, Dd^Ftd, Dd, Gd^Fts, Gd, Gd^Es, Gd, Dd, Dd, Gs^Ftp, Dd, Dd, Dd, Dd, Dd, Hd, Hd
Dd^Ftd, Dd, Gd^Es, Rd, Hhd^Vht, Hhd, Hhd, Hhd, Gd, Rd, Dd, Dd, Gs^Ftp, Dd, Rd, Dd^Ftd, Dd, Dd^Esd, Dd^Esd, Gd^Fts, Gd^Fts, Gd^Fts, Gd^Fts, Dd, Dd, Gs, Dd, Dd, Dd, Dd^Ftd, Hd, Rd
Dd, Dd, Gd^Fts, Rd, Rd, Hd, Hd, Hd, Rd, Rd, Dd^Vda, Dd^Ftd, Wwf, Re, Dd, Dd^Ftd, Dd^Ftd, Dd^Do, Dd, Dd^Esd, Gd^Fts, Gd^Efm, Gd, Dd^Edpp, Wwf, Wwf, Wwf, Dd^Ftd, Dd, Hd^Vdt, Hd, Mdd
Dd^Esd, Dd^Edp, Dd^Esd, Gd, Rd, Dd, Hd, Hd, Rd, Dd, Rd, Rd, Re, Rd, Dd, Dd, Dd, Dd, Dd, Dd, Dd, Gd, Gd, Wwf^Vhs, Ww, Wwr, Wwf, Dd, Dd, Hd, Hd, Hd
Dd, Dd^Ftd, Dd, Rd, Dd^Ftd, Dd, Dd, Rd, Rd, Rd, Dd^Ftd, Dd^Dr, Dd, Dd^Esd, Dd, Dd, Dd, Dd, Rd, Dd, Rd, Rd, Re, Wwf, Wwf, Wwf, Gs, Gd^Fts, Dd, Hd, Hd, Hhd
Dd^Esd, Dd, Dd^Esd, Rd, Dd^Esd, Dd^Edb, Rd, Rd, Rd, Dd, Dd, Dd^Edb, Gd^Fts, Dd, Rd, Rd, Rd, Rd, Gd^Vht, Rd, Gd^Fts, Gd, Dd^Esd, Re, Wwf, Gd, Gd, Gd^Fts, Gd^Fts, Hd, Hhd, Hhd
Dd, Dd, Gs, Wwf, Gs, Dd, Rd, Rd, Dd^Ftd, Dd, Rd, Rd, Rd, Rd, Dd^Edp, Dd^Edp, Dd^Edp, Dd, Gd^Fts, Gd^Fts, Dd, Gd, Gd, Gd^Fts, Dd, Rd, Rd, Gd^Fts, Rd, Gd^Fts, Rd, Rd
Dd^Ftd, Dd, Wwf, Wwf, Wwf, Wwf, Wwf, Rd, Rd, Rd, Dd^Ftd, Dd, Dd, Dd^Edb, Dd^Esd, Dd, Dd, Dd^Esd, Gd^Fts, Gd^Fts, Dd, Hd, Gd^Fts, Dd, Dd, Dd^Esd, Gd^Fts, Rd, Gd^Fts, Rd, Dd^Edpp, Dd
Dd, Wwf, Wwf, Cd, Cd, Cd, Ww, Wwf, Rd, Gd^Fts, Rd, Dd^Dr, Dd^Esd, Dd^Ftd, Dd^Ftd, Dd^Ftd, Dd^Ftd, Dd, Rd, Hd, Rd, Hd, Rd, Dd^Esd, Rd, Cd, Cd, Cd, Gd^Fts, Gd^Fts, Dd^Edb, Dd^Esd
Rd, Re, Wwf, Cd, 4 Kd, Cd, Wwr, Wwf, Wwf, Rd, Dd, Rd, Rd, Rd, Rd, Rd, Rd, Rd, Dd, Rd, Dd, Rd, Dd^Vda, Rd, Dd, Cd, 3 Kd, Cd, Dd, Dd^Vda, Dd^Dr, Dd^Ftd
Gd^Fts, Gd, Gd, Wwf, Wwf^Vhs, Ww, Ww, Ww, Wwf, Wwf, Wwf, Dd^Vda, Dd^Ftd, Dd^Do, Dd^Ftd, Dd^Edp, Dd^Esd, Dd^Esd, Dd, Dd, Dd, Gd^Fts, Dd, Dd^Esd, Dd, Dd, Dd, Dd, Dd^Esd, Dd^Edpp, Dd^Esd, Dd
Gd, Dd, Dd^Edpp, Dd, Gs, Wwf, Ww, Ww, Wwf, Wwf, Gs^Ftp, Dd^Ftd, Dd^Ftd, Dd^Ftd, Dd, Dd^Ftd, Dd^Ftd, Dd, Dd^Vdr, Gd^Fts, Gd^Fts, Gd, Gd^Fts, Dd, Dd, Dd, Dd^Ftd, Dd^Ftd, Dd^Edpp, Dd, Dd, Dd^Edp
Gd^Fts, Gd, Gd, Dd^Edp, Dd, Dd, Wwf, Wwf, Wwf, Wwf, Dd, Dd, Dd, Dd, Dd^Ftd, Dd^Esd, Dd^Ftd, Dd^Esd, Dd, Dd^Esd, Gd, Gd, Gd^Fts, Dd^Do, Dd, Dd^Esd, Dd, Dd, Dd^Esd, Dd, Dd^Ftd, Dd^Ftd
Gd^Fts, Gd^Fts, Gd, Dd, Dd^Dr, Dd, Gd^Fts, Dd, Dd^Ftd, Gs^Ftp, Dd, Dd^Ftd, Dd, Dd, Dd^Ftd, Dd, Dd^Ftd, Dd, Dd, Dd^Esd, Gd^Fts, Gd, Dd, Dd, Dd^Ftd, Dd, Dd^Esd, Dd^Ftd, Dd, Dd^Esd, Ww, Ww
Dd, Gd^Fts, Dd, Gd^Es, Gd^Es, Gd, Dd^Edpp, Dd, Dd^Ftd, Dd^Edb, Dd^Ftd, Dd, Gd^Fts, Dd^Esd, Dd, Dd, Dd^Edp, Dd^Ftd, Dd, Dd, Dd^Esd, Dd, Dd, Dd, Dd^Esd, Dd, Dd^Esd, Dd, Dd^Esd, Dd, Dd, Ww
